11111111111111111111
1                  1
1            0     1
1            0     1
1   0         0    1
1        0   0     1
1            0     1
1             000001
1         00000    1
1   0000000        1
1                  1
1             0    1
1                  1
1    0             1
1                  1
1                  1
1                  1
1                  1
1                  1
111111111   11111111