11111111111111111111
1                  1
100000000000       1
1          0       1
1          0       1
1          0       1
1          0       1
1          0       1
1          0       1
1          0       1
1          0       1
1                  1
1    000000000000001
1                  1
1                  1
1                  1
1111111111111111   1
1                  1
1                  1
111111111  111111111