11111111111111111111
1                  1
100000000000       1
1          0       1
1          0       1
1          0       1
1          0       1
1          0       1
1          0       1
1          0       1
1          0       1
1                  1
1    000000000000001
1                  1
1    0           0 1
1             0 0  1
1  0  0   00 0     1
1   0   0          1
1 0         0    0 1
11111111     1111111