11111111111111111111
1                  1
1                  1
10000000000000000  1
1                  1
1   1111111        1
1   1     1        1
1         1   000001
1         1        1
10000000000        1
1             111111
1000          1    1
1             0    1
1  0          00   1
1  0           1   1
1  0           1   1
1  0           1   1
1  0               1
1  0               1
111111111   11111111