11111111111111111111
1                  1
1                  1
1                  1
1    000   000     1
1    0       0     1
1    0       0     1
1    0       0     1
1    0       0     1
1    0       0     1
1    0       0     1
1    0       0     1
1    000000000     1
1                  1 
1                  1
1                  1
1                  1
1                  1
1                  1
111111111   11111111